 13x6
 ********* 
 *    |    * 
 *   |||   * 
 *  |||||  * 
 * ||||||| * 
 *********